NO ../tests/cube3D/textures/wolfenstein/grey_stone.xpm
SO ../tests/cube3D/textures/wolfenstein/purple_stone.xpm
WE ../tests/cube3D/textures/wolfenstein/red_brick.xpm
EA ../tests/cube3D/textures/wolfenstein/wood.xpm

F 18,53,25
C 153,204,255

111111111111
1         11
1       1111
111111110011
10000000000S	
111111111111
1          1
111111111111
