111111111111111111111111
1111111111P1111100000011
111111111100000101111011
111111111111110100011011
111111111111110111011011
11111111111111000C011011
111111111111111111111011
111111111111111111111011
111111111111110000000011
11111111111111E111111111
111111111111111111111111
