11111111111111111
1CCCCCCCCCCCCCCC1
1CCCCCCCPCCCCCCC1
1CCCCCCCCCCCCCCC1
1CCCCCCCCCCCCCCC1
1CCCCCCCCCCCCCCE1
1CCCCCCCCCCCCCCC1
11111111111111111
