111111111111111111111111
100000000000000C00000001
100000000000000000000001
1000000000000000000000C1
100C0000000000000000P001
100000000000000000000001
100000000000000000000001
100000000000000C00000001
100000000000000000000C01
1000000000E0000000000001
111111111111111111111111
