111111111111111111111111
1000001101110000000000C1
100000000011000001111111
100000000001000000000001
100P00000000000000100001
100000000000000000100001
100000C00000110000100001
10000000000011000C1000C1
100001111111111111100001
10C0000000E0000110000001
111111111111111111111111
