1111111111
1E000C00P1
1111111111
