1111111111
10C0000001
10000P0001
1E0000E001
1111111111
