1111111111
11C0000001
1E100P0001
1100000001
1111111111
