1111011111
10C0000001
10000P0001
100000E001
1111111111
