1111111111
10C0000001
11000P0001
1E10000001
1111111111
