1111111111
1E10000001
11000P0001
100C000001
1111111111
