11111111111111111111
1000000000C000000001
1000P0000000000E0001
10000000000000000001
11111111111111111111
