1111111111
1001000001
101C1P0001
100100E001
1111111111
