1111111111
10C1E10001
10001P0001
1000000001
1111111111
