1111111111
1C10000001
11000P0001
100000E001
1111111111
