1111111111
1000000001
10000P0011
100000E1C1
1111111111
