1111111111
10C00001E1
10000P0011
1000000001
1111111111
