1111111111
10C0000001
10001P0001
1001E10001
1111111111
