1111111111
10C0000001
10000P0001
1C0000C001
1111111111
