1111111111
100000P001
10C00P0001
100000E001
1111111111
