1111111111
1000000001
11000P0001
1C1000E001
1111111111
