1111111111
1000000011
10000P01C1
100000E011
1111111111
