1111111111
10000001C1
10000P0011
100000E001
1111111111
