111111111111111111111111
1000001101110000000000C1
100000000011000000000001
100000000001000000000001
100P0000000g000000100001
100000000000000000100001
100000C00000110000100001
10000000000011000C1000C1
100001111111111111100001
10C0000000E0000000000001
111111111111111111111111
