1111111111
1100000001
1C100P0001
110000E001
1111111111
