1111111111
1001C10001
10001P0001
100000E001
1111111111
