1111111111
10C0000001
10000C0001
100000E001
1111111111
