1111111111
10C0000011
10000P01E1
1000000011
1111111111
