1111111111
10C0000001
10000P0011
10000001E1
1111111111
