NO ../tests/cube3D/textures/exit.xpm
SO ../tests/cube3D/textures/chest.xpm
WE ../tests/cube3D/textures/slime.xpm
EA ../tests/cube3D/textures/wall.xpm

C 125, 230, 4
F 124, 23, 14

111111111111111111111111111111111111111111111
100000000000000000000000011111000000111000001
100001100000000000011100000000000000000000001
100010000000000000000100000010000001000000001
100011110000011100000100000111000001000000001
100010000000010000000000000010000001000000001
100010000000111100000000000000011111111111111
100000000000000111000000000000000000000100001
100000000000000000000001100000000110000100001
101000011111111110000001100000000010000111001
101110001000000010011000000110000010000000001
101010001000111110011000000110000000000000001
10001000110010000111111111111111111111111111
10111110000011001
10010010000000011
101000101111111
111000001110011111111111111111111
   100100000000000E00000000000001
   10011111000000000000111111111
   11111111111111111111