NO ../tests/cube3D/textures/exit.xpm
SO ../tests/cube3D/textures/chest.xpm
WE ../tests/cube3D/textures/slime.xpm
EA ../tests/cube3D/textures/wall.xpm

C 125,       230,4
F 124,23,14

111111111111111
100101000000001
100000000000001
100000110000001
101000000000001
100000000000001
1N0000000000001
100000000000001
111111111111111